*/sports	basketball_player,tennis,golf,sport,athletes,basketball,athlete,hockey,sports,football
*/politics	medicaid,affordable_care_act,abortion,gov,immigration,law_enforcement,gay_rights,president_obama,health_care,advocates
*/business	stocks,sector,goods,manufacturing,prices,exports,euro,export,inventories,electricity
*/arts	premiere,hbo,studio,theater,movies,broadway,arts,dance,movie,comedy
*/city	inning,rockies,rays,mars,spacewalk,astros,white_sox,royals,nasa,bullpen
*/sports/basketball	boston_celtics,miami_heat,los_angeles_lakers,kobe_bryant,lakers,lebron_james,nba,los_angeles_clippers,celtics,carmelo_anthony
*/sports/tennis	sharapova,sloane_stephens,serena_williams,agnieszka,victoria_azarenka,roger_federer,andy_murray,djokovic,tennis,maria_sharapova
*/sports/golf	muirfield,merion,layout,merion_golf_club,golfers,courses,golf,golfing,british_open,phil_mickelson
*/sports/baseball	biogenesis,ryan_braun,mlb,steroids,braun,selig,slugger,major_league_baseball,alex_rodriguez,rodriguez
*/sports/hockey	goaltenders,henrik_lundqvist,goalies,goaltender,defenseman,nhl,goalie,martin_brodeur,hockey,lundqvist
*/sports/quarterback	quarterback,defensive_lineman,left_tackle,backup_quarterback,defensive_end,qb,crimson_tide,defensive_coordinator,philadelphia_eagles,linebacker
*/sports/striker	barcelona,real_madrid,striker,midfielder,portuguese,everton,juventus,chelsea,ac_milan,fernando_torres
*/sports/fans	pranks,extended_family,turley,john_brown,ladner,mohawk,neshek,confederate,lacrosse,pearl_jam
*/politics/budget	spending_cuts,cuts,budget_cuts,deficits,fiscal,budget,sequestration,sequester,entitlement,federal_budget
*/politics/surveillance	snowden,national_security_agency,logs,phone_records,spying,surveillance,disclosures,metadata,foreign_intelligence_surveillance_court,classified_documents
*/politics/immigration	deportation,immigrants,illegal_immigrants,citizenship,border,immigrant,unauthorized,immigration,illegal_immigration,pathway
*/politics/law_enforcement	shootings,killings,gunman,police_officers,deputies,police,kaufman_county,hasse,law_enforcement,county_sheriff
*/politics/gay_rights	lesbians,homosexuality,sexual_orientation,lesbian,gay,gays,gay_rights,equality,marriages,mormon
*/politics/abortion	fetal_heartbeat,abortion_clinics,ultrasound,abortion_providers,abortions,pregnancy,rights_advocates,abortion,ambulatory,fetus
*/politics/insurance	health_coverage,insurers,marketplaces,marketplace,exchanges,premiums,health_insurance,coverage,insurance,exchange
*/politics/rules	card_check,environmental_review,environmentalists,clean_air_act,nongovernmental_organizations,petitions,clean_water_act,divestment,swarthmore,osha
*/politics/republican	romney,christie,campaign_manager,fund_raiser,john_kerry,nominees,cuccinelli,nominating,republican_party,united_states_senate
*/politics/law	truancy,victimization,counseling_program,federal_prisons,randa,educators,spirit_lake,ritz,invasive_species,curriculum
*/business/stocks	indexes,traders,stocks,stock_market,wall_street,dow,stock,nasdaq,shares,dow_jones_industrial_average
*/business/electricity	power_plants,cleaner,fossil_fuels,natural_gas,electricity,coal,generators,carbon,greenhouse_gas,nuclear_power
*/business/economy	job_growth,job_market,economic_recovery,economic_growth,slowdown,july_september,job_creation,personal_consumption,unemployment_rate,millan
*/business/euro	finland,portugal,hungary,greece,germans,europeans,angela_merkel,brussels,southern_europe,bulgaria
*/business/products	infant_formula,nestl,tetra_pak,milk_powder,dairy,beef,vitamin,beijing,fonterra,faux_fur
*/business/euro_zone	governing_council,personal_income,recessions,inflows,currency_union,winkler,exchange_rate,exchange_rates,weinberg,currency
*/business/volkswagen	nissan,automaker,chrysler,volkswagen,toyota,airbus,airline,audi,automakers,automotive
*/arts/dance	dancers,jazz,ensemble,musicians,dancing,repertory,composer,dance,classical,composers
*/arts/television	networks,cable,network,cbs,channel,cable_channels,channels,nbc,cbs_sports_network,cbs_sports
*/arts/movies	box_office,sequels,studios,documentaries,steven_spielberg,hollywood,films,cinema,warner_brothers,blockbuster
*/arts/ms	mandela,saturday_night_live,dougherty,vall_e,downton,streep,stewardess,fellowes,rayon,dubuc
*/arts/images	frames,dolce_gabbana,humanoid,atlantis,robot,bezos,kite,mainlanders,spaceship,zoo
*/arts/comic	suspense,dobie,mister_cee,zelda,treme,ty_dolla_sign,statham,insane_clown_posse,reddington,sightseers
*/city/buffalo	panthers,carolina,buffalo,jets,ottawa,overtime,islanders,callahan,talbot,flyers
*/city/scientists	scientists,humans,animals,genes,dna,mars,neurons,dinosaurs,particles,experiments
*/city/inning	inning,bullpen,innings,homer,padres,pinch_hitter,braves,ninth_inning,relievers,reds
